NO ./imgs/TECH_0E.xpm
SO ./imgs/TECH_0D.xpm
EA ./imgs/TECH_0G.xpm

C 0,0,51

F 255 , 5698282951,50

WE ./imgs/TECH_0F.xpm

1111111111111111111111111
1000000000000000000000001
10N0000000000000000000001
1000000000000000000000001
1000000000000000000000001
1000000000000000000000001
1000000000000000000000001
1000000000000000000000001
1000000000000000000000001
1000000000000000000000001
1000000000000000000000001
10000000000000000000000X1
1111111111111111111111111
