NO ./imgs/TECH_0E.xpm
WE ./imgs/TECH_0F.xpm
EA ./imgs/TECH_0G.xpm
SO ./imgs/TECH_0D.xpm

C 0,0 , 51

F 51,51,50

111111111111111
1S10000010001X1
1010111010101C1
1K10000000100K1
101111111C11111
10C000001000001
111010101111101
111011100000001
100010111111111
101110100000001
1K00C0101111101
101110001K00001
101001111111111
1C101111000C001
101000001111101
10001110C000001
111111111111111
