NO ./imgs/TECH_0E.xpm
SO ./imgs/TECH_0D.xpm
EA ./imgs/TECH_0G.xpm

C 0,0,51

F 51,51,50

WE ./imgs/TECH_0F.xpm

111111111111111111111111111111
100000000000000000000001      
10N000000000000000000001      
100000000000000000000000111111
1111000000000000000000001
    1000000000000000000011
    11110000000000000000C1
    1111000000000000000011
    111100000000000000001111111
1111000000000000000000001
1000000000000000000000001
1000000000000000000000001
1000000000000000000000001
10000000000000000000000X1
1111111111101111111111111
           1