1111111111111
100000000C001
1001000000001
100000X000101
1000000C00011
1000001000001
1P0000E000001
1111111111111
